00000093
0000a087
0040a107
0080a187
00c0a207
002082d3
0050a827
0100a103
407001b7
08311463
10328353
e0030253
40f002b7
06521e63
183203d3
e0038353
409003b7
06731863
58020453
c0040453
00300493
06941263
e0040953
404009b7
07391063
02a00613
d00604d3
e00486d3
42280737
04e69863
0ff00793
d0178553
00a0aa27
0140a803
437f08b7
03181e63
00100513
0000006f
05b00513
0000006f
05c00513
0000006f
05d00513
0000006f
05e00513
0000006f
05f00513
0000006f
06000513
0000006f
06100513
0000006f